0000000000000
0000000000000
0000000000000
0000000000000
AAAAAAAAAAAAA
RRRRRRRRRRRRR
YYYYYYYYYYYYY
BBBBBBBBBBBBB
GGGGGGGGGGGGG