0O00000000000
0000000000000
0O00000000000
0O00000000000
0O00000000000
0O00000B00000
000000BYB0000
0O000BYGYB000
0O00BYGYGYB00
0O0BYGYAYGYB0
0O00BYGYGYB00
0O000BYGYB000
000000BYB0000
0O00000B00000
0O00000000000
0O00000000000
0O00000000000
0OOOOOOOOOOOO