0000000000000
0000000000000
0000000000000
0000000000000
000000A000000
000BBBAGGG000
00BBBRRRGGG00
00BBRRRRRGG00
0BBBRRRRRGGG0
0BBBRRRRRGGG0
0BBBRRRRRGGG0
0A00A0A0A00A0
000000A000000
000000A000000
000000A000000
0000O0O000000
0000OOO000000
00000O0000000