0000000000000
0000000000000
000Y00000Y000
000Y00000Y000
0000Y000Y0000
0000Y000Y0000
000AAAAAAA000
000AAAAAAA000
00AARAAARAA00
00AARAAARAA00
0AAAAAAAAAAA0
0AAAAAAAAAAA0
0AAAAAAAAAAA0
0A0AAAAAAA0A0
0A0A00000A0A0
0A0A00000A0A0
0000AA0AA0000
0000AA0AA0000