0000000000000
0000000000000
0000000000000
GGGGGGGGGGGGG
0000000000000
GGGOOOOOOOOOO
0000000000000
YYYYYYYYYYYYY
0000000000000
OOOOOOOOOOYYY
0000000000000
BBBBBBBBBBBBB
0000000000000
BBBOOOOOOOOOO
0000000000000
RRRRRRRRRRRRR